11111111111111
1P0000C0001C11
10111101111101
1010000C1001C1
10101111111101
1C000C00000E01
11111111111111